{
    "groundTextureUrl": "./textures/ground.jpg",
    "wallTextureUrl": "./textures/wall.jpg",
    "size": { "width": 10, "height": 10 },
    "map": [
        [3, 2, 2, 2, 5, 5, 2, 2, 2, 2, 1],
        [1, 0, 0, 0, 1, 1, 0, 0, 0, 0, 1],
        [1, 0, 0, 0, 1, 1, 0, 0, 0, 0, 1],
        [3, 2, 2, 2, 4, 5, 2, 2, 2, 2, 1],
        [1, 0, 0, 0, 1, 1, 0, 0, 0, 0, 1],
        [1, 0, 0, 0, 1, 1, 0, 0, 0, 0, 1],
        [5, 2, 2, 2, 0, 1, 0, 0, 0, 0, 1],
        [3, 2, 2, 2, 1, 3, 2, 2, 2, 2, 1], 
        [1, 0, 0, 0, 1, 1, 0, 0, 0, 0, 1],
        [1, 0, 0, 0, 4, 4, 0, 0, 0, 0, 1],
        [2, 2, 2, 2, 2, 2, 2, 2, 2, 2, 0] 
    ], 
    "initialPosition": [2, 2],
    "initialDirection": 0.0,
    "exitLocation": [-0.5, 6]
}